
NO ./textures/paint_wall.xpm
SO ./textures/window_wall.xpm

WE ./textures/calendar_wall.xpm
EA ./textures/clock_wall.xpm

F 255,255,0
C 51,255,255

111111111111111
1000010000000001
1000S100000000011111111111111111111111111111
10000100011110110000000000000000000000000001
11110110110100000000000000000000000000111001
100001001111000000000011111111111111001 1001
10000100000000011100001            1001 1001
100001101100111111000011111111111111001 1001
1000000000000001 100000000000000000000111001
1000000000001101 100000000000000000000000001
1111111101111111 100000000000000000000000001
       101       111111111111111111111000001
       101                           1000001
       101                           1000001
       1011111111111111111111111111111000001
       1000000000000000000000000000000000001
       1111111111111111111111111111111000001
                                     1111111

