


NO ./textures/paint_wall.xpm
SO ./textures/window_wall.xpm

WE ./textures/calendar_wall.xpm
EA ./textures/clock_wall.xpm

F 220,100,0
C 225,30,0

 11111111111111111111111
1000000000110000000000001
1011000001110000000000001
100100000000000000000000111111111
111111111011000001110000000000001
10000000011000001110111111111111
11110111111111011100000010001
111101    111101 101010010001
11000011110101011100000010001
10000000000000001100000010001
10000000000000001101010010001
11000001110101011111011110N111
11110111 1110101 101111010001
11111111 1111111 111111111111
