


NO ./textures/test_no.xpm
SO ./textures/test_so.xpm

WE ./textures/test_we.xpm
EA ./textures/test_ea.xpm

F 220,100,0
C 225,30,0



      1111111111
      1000000001
      1111111111     111111
                     100001
                     111111

 11111111111111111111111
1000000000110000000000001
1011000001110000000000001
100100000000000000000000111111111
111111111011000001110000000000001
100000000011000001110111111111111
11110111111111011100000010001
111101    111101 101010010001
11000011110101011100000010001
10000000000000001100000010001
10000000000000001101010010001
11000001110101011111011110N0111
11110111 1110101 101111010001
11111111 1111111 111111111111

