


NO ./textures/paint_wall.xpm
SO ./textures/window_wall.xpm

WE ./textures/calendar_wall.xpm
EA ./textures/clock_wall.xpm

F 255,255,0
C 51,255,255

 11111111111111111111111
1000000000110000000000001
101100000111000000000N001
100100000000000000000000111111111
10000001011000001110000000000001
10000000011000001110111111111111
11110111111111011100000010001
111101    111101 101010010001
11000011110101011100000010001
10000000000000001100000010001
10000000000000001101010010001
110000011101010111110111100111
11110111 1110101 101111010001
11111111 1111111 111111111111
