
NO ./textures/paint_wall.xpm
SO ./textures/window_wall.xpm

WE ./textures/calendar_wall.xpm
EA ./textures/clock_wall.xpm

F 255,255,0
C 51,255,255


1111111111111111
1000000000000001
1000010000000001
10E0000000000001
1000010000000001
1000000000000001
1000000000000001
1000000011010101
1000000000000001
1000000000000001
1111111111111111
