
NO ./textures/paint_wall.xpm
SO ./textures/window_wall.xpm

WE ./textures/calendar_wall.xpm
EA ./textures/clock_wall.xpm

F 255,255,0
C 51,255,255
                       1111
                     11000011
                    1000000001
   1111111111111111100000000001
  1000000000000000010000000001
11000000000000000000100000001
111100000000W000000000000001
11000000000000000000100000001
  1000000000000000010000000001
   1111111111111111000000000001
                   10000000001
                    100000001
                     1100011
                       111
